ConText
An Interactive Fiction by Zoe "Fish" Cagle
Release 1 / Serial number 160117 / Inform 7 build 6M62 (I6/v6.33 lib 6/12N) SD

bedroom
You're pretty sure this used to be your bedroom... This must be some kind of weird dream.

A standard-issue maroon chair sits awkwardly in the corner.

There aren't any doors in or out, but there's a window to the east.

>look away
You stare pointedly at the other side of the room. The window seems relieved.

>go through window
(first opening the window)
Watching the far wall, you back up to the window and tug at the pane. Your arms don't quite bend that way, but you manage to slide it open eventually.

Carefully, you step backwards through the window. It's very a stressful moment for you both. But with some manuvering, you fall ungracefully into the next room.

hallway
This was once your lengthy, rectangular hallway. But now it's some strange, circular room with a tiled design on the floor.

The window appears to have fled.

There's a single red door leading to what you're reasonably sure is the kitchen.

>n
You try, but it disappears before you can reach it. ...You should probably try to figure out where it will be, first.

>n
You make a lunge for the doorway...

...But end up with a face full of wall. The door seems to be south now.

>n
You make a lunge for the doorway...

...But end up with a face full of wall. The door seems to be west now.

>n
You make a lunge for the doorway...

...But end up with a face full of wall. The door seems to be east now.

>n
You make a lunge for the doorway...

...And make it into the kitchen.

kitchen
Well, at least the kitchen looks mildly familiar. On the counter is an innocuous black box.

You can see a small hopper window, but it's too high to reach.

There's a single red door leading to the hallway.

>n
You can't go that way.

>n
You can't go that way.

* * *

>n
You make a lunge for the doorway...

...And make it into the kitchen.

kitchen
Well, at least the kitchen looks mildly familiar. On the counter is an innocuous black box.

You can see a small hopper window, but it's too high to reach.

There's a single red door leading to the hallway.

>take window
That's fixed in place.

>examine window
You could probably squeeze your way through if you could reach it...

>reach window
That's not a verb I recognise.

>jump
You jump on the spot.

>jump to window
I only understood you as far as wanting to jump.

>examine counter
On the kitchen counter is an innocuous black box.

>take box
Taken.

>examine box
It is suspiciously casual. On the top is a large, shiny, unassuming red button.

>press button
Click.

>press button
Click.
The giant worm waits patiently for you to notice it.

>press button
Click.
The giant worm shifts nervously. It hopes it isn't being a bother.

>look
kitchen
You are in the kitchen. The worm has left the floor in splinters.

You can see a small hopper window, but it's too high to reach.

There's a single red door leading to the hallway.

You can also see a giant worm here.

The giant worm awkwardly sinks back into the floor a little bit. It worries that you might have left without acknowledging it.

>examine worm
Eyeless and slimy, the beast fills nearly the entire room. You're not sure how you didn't hear it erupt through the floor.

The giant worm worries that it may have offended you somehow.

>notice worm
The giant worm is blind, and is uncertain that you have noticed it. Maybe a slight tap?

The giant worm waits nervously for you to notice it.

I beg your pardon?

>take worm
I don't suppose the giant worm would care for that.

The giant worm waits nervously for you to notice it.

>tap worm
The giant worm is still uncertain that you have noticed it. It's possible that you've only brushed up against it by accident. Maybe you should try talking to it.

The giant worm waits nervously for you to notice it.

>talk to worm
you tell the giant worm about yourself.

The giant worm is pleased that you acknowledged it.
 It promptly begins to gnash its teeth at you. The giant worm has many teeth.

You duck out of the way as the worm takes a chomp at you.

You take some damage -- your arm is no longer in the best shape.
You should probably let that heal.

>run away
You can't seem to find a way back.

The worm swings its head at you like a wrecking ball. You slam into the wall.

You take some damage -- a bruise forms just below your hairline.

>run away
You can't seem to find a way back.

The worm slices at you with its razor teeth, but you dodge...mostly.

You take some damage -- you're pretty sure that sprained something.

>s
hallway
This was once your lengthy, rectangular hallway. But now it's some strange, circular room with a tiled design on the floor.

There's a single red door leading to the kitchen.

You've managed to fix yourself up a little -- but the pain still makes you a little nauseous.

The giant worm tries to follow, but gets stuck in the door. It wiggles through slowly and carefully, so as not to hurt the frame (but makes sure to snap viciously at you anyway).

>look around
hallway
This was once your lengthy, rectangular hallway. But now it's some strange, circular room with a tiled design on the floor.

There's a single red door leading to the kitchen.

You can also see a giant worm here.

The worm headbutts you gently.

You take some damage -- now there's a nasty-looking gash on your knee.

>examine worm
Eyeless and slimy, the beast fills nearly the entire room. You're not sure how you didn't hear it erupt through the floor.

You've managed to fix yourself up a little -- but you're still in a bit of pain.

You duck out of the way as the worm takes a chomp at you.

You take some damage -- now there's a nasty-looking gash on your knee.

>w
You make a lunge for the doorway...

...But end up with a face full of wall. The door seems to be south now.

The worm headbutts you gently.

You take some damage -- you're pretty sure that sprained something.

>w
You make a lunge for the doorway...

...But end up with a face full of brick. Looks like west doesn't lead anywhere.

The worm slices at you with its razor teeth, but you dodge...mostly.

You take some damage -- your arm is no longer in the best shape.

* * *

>press button
Click.

>s
hallway
This was once your lengthy, rectangular hallway. But now it's some strange, circular room with a tiled design on the floor.

There's a single red door leading to the kitchen.

The giant worm waits patiently for you to notice it.

>n
You try, but it disappears before you can reach it. ...You should probably try to figure out where it will be, first.

The giant worm shifts nervously. It hopes it isn't being a bother.

>n
You make a lunge for the doorway...

...But end up with a face full of wall. The door seems to be west now.

The giant worm awkwardly sinks back into the floor a little bit. It worries that you might have left without acknowledging it.

>n
You make a lunge for the doorway...

...But end up with a face full of wall. The door seems to be east now.

The giant worm worries that it may have offended you somehow.

>n
You make a lunge for the doorway...

...And make it into the kitchen.

kitchen
You are in the kitchen. The worm has left the floor in splinters.

You can see a small hopper window, but it's too high to reach.

There's a single red door leading to the hallway.

You can also see a giant worm here.

The giant worm waits nervously for you to notice it.

* * *

>look away
You stare pointedly at the other side of the room. The window seems relieved.

>e
(first opening the window)
Watching the far wall, you back up to the window and tug at the pane. Your arms don't quite bend that way, but you manage to slide it open eventually.

Carefully, you step backwards through the window. It's very a stressful moment for you both. But with some manuvering, you fall ungracefully into the next room.

hallway
This was once your lengthy, rectangular hallway. But now it's some strange, circular room with a tiled design on the floor.

The window appears to have fled.

There's a single red door leading to what you're reasonably sure is the kitchen.

>n
You make a lunge for the doorway...
...But end up with a face full of wall.

>n
You make a lunge for the doorway...

...But end up with a face full of wall. The door seems to be south now.

* * *

>n
You make a lunge for the doorway...

...But end up with a face full of wall. The door seems to be east now.

>n
You make a lunge for the doorway...

...And make it into the Kitchen.

Kitchen
Well, at least the kitchen looks mildly familiar. On the counter is an innocuous black box.

You can see a small hopper window, but it's too high to reach.

There's a single red door leading to the hallway.

>take box
That's fixed in place.

>press button
Click.

>l
kitchen
You are in the kitchen. On the counter is an innocuous black box.The worm has left the floor in splinters.

You can see a small hopper window, but it's too high to reach.

There's a single red door leading to the hallway.

You can also see a giant worm here.

The giant worm waits patiently for you to notice it.

>talk to worm
you ask the giant worm about their day.

The giant worm is pleased that you acknowledged it. It promptly begins to gnash its teeth viciously at you in response. The giant worm has many teeth.

>s
hallway
This was once your lengthy, rectangular hallway. But now it's some strange, circular room with a tiled design on the floor.

There's a single red door leading to the kitchen.

The giant worm tries to follow, but gets stuck in the door. It wiggles through slowly and carefully, so as not to hurt the frame (but makes sure to snap viciously at you anyway).

>e
You try, but it disappears before you can reach it. ...You should probably try to figure out where it will be, first.

The worm slices at you with its razor teeth, but you dodge...mostly.

You take some damage -- you're pretty sure that sprained something.
You should probably let that heal.

>e
You make a lunge for the doorway...

...And make it into the spare room.

spare room
This room is pretty dim and empty. There are a green chair, a blue chair and a yellow chair huddled in the corner.

There's a large decorative door to the south that you're pretty sure could hold back the worm.

You've managed to fix yourself up a little --in fact, you'd say you're at peak health!

The giant worm manages to squeeze through its current door, but gets stuck again in the next one. It wiggles through slowly and carefully, so as not to hurt the frame (but makes sure to snap viciously at you anyway).

>take chair
Which do you mean, the green chair, the blue chair or the yellow chair?

>take green chair
Taken.

The worm headbutts you gently.

You take some damage -- you're pretty sure that sprained something.

>take blue chair
Taken.

You've managed to fix yourself up a little -- but you're still in a bit of pain.

The worm swings its head at you like a wrecking ball. You slam into the wall.

You take some damage -- a bruise forms just below your hairline.

>take yellow chair
Taken.

You duck out of the way as the worm takes a chomp at you.

Badly injured and taking the brunt of the force, you black out...

    *** The End ***

Would you like to RESTART, RESTORE a saved game, QUIT or UNDO the last command?

>diagnose
You'd rate your pain at a seven, but you can ride it out.

You duck out of the way as the worm takes a chomp at you.

Badly injured and taking the brunt of the force, you black out...

    *** The End ***

Would you like to RESTART, RESTORE a saved game, QUIT or UNDO the last command?

* * *

>s
you slam the door shut and lock it behind you.

living room
There's a large decorative door to the east. It's locked tight.

A mannequin sits in the corner of the room.

You can also see a sign here.

>examine mannequin
There's a knothole in the wood where its eye should be.

You've managed to fix yourself up a little --in fact, you'd say you're at peak health!

>examine knothole
Nothing inside. You're also slightly tempted to stick your finger through it.

>take knothole
The mannequin leans away from you, offended that you would even consider such a thing.

>take mannequin
I don't suppose the mannequin would care for that.

>poke mannequin
The wood is well-varnished and superbly polished.

>tell mannequin no poking
I didn't understand that sentence.

>tell mannequin "no poking"
I didn't understand that sentence.

>tell mannequin about "no poking"
The mannequin shifts. Its arms seem to move independently of...themselves. That is, although they stay stiffly crossed behind the mannequin's back, they also gesture -- almost like a hologram -- as it tries to speak...

Unfortunately, the mannequin does not seem to have a mouth.

>examine mouth
You can't see any such thing.

>pat mannequin
The wood is well-varnished and superbly polished.

The mannequin is still trying to speak to you.

>hug mannequin
The mannequin abashedly hides its face in its hands.

The mannequin seems frustrated.

>talk to mannequin
you ask the mannequin about themself.

There is no reply.

After a few minutes of deliberation, the mannequin opts to communicate by prodding at your forehead.

>give mannequin papeer
You can't see any such thing.

>give mannequin paper
You can't see any such thing.

>i
You are carrying nothing.

The mannequin continues to poke uselessly at your forehead.

>take mannequin
I don't suppose the mannequin would care for that.

The mannequin continues to poke fruitlessly at your forehead. Whatever it's trying to do, it's not working.

>talk to mannequin
Finally, you snap. You swat the mannequin's hand and tell it to stop.
The mannequin reluctantly withdraws and respects your personal space.

>look around
living room
There's a large decorative door to the east. It's locked tight.

The mannequin sways to some nonexistent tune.

You can also see a sign here.

* * *

>n
You make a lunge for the doorway...

...And make it into the Kitchen.

Kitchen
Well, at least the kitchen looks mildly familiar. On the counter is an innocuous black box.

You can see a small hopper window, but it's too high to reach.

There's a single red door leading to the hallway.

>press button
Click.

>talk to worm
you ask the giant worm about their day.

The giant worm is pleased that you acknowledged it. It promptly begins to gnash its teeth viciously at you in response. The giant worm has many teeth.

>s
hallway
This was once your lengthy, rectangular hallway. But now it's some strange, circular room with a tiled design on the floor.

There's a single red door leading to what you're reasonably sure is the kitchen.

The giant worm tries to follow, but gets stuck in the door. It wiggles through slowly and carefully, so as not to hurt the frame (but makes sure to snap viciously at you anyway).

>e
You make a lunge for the doorway...
...But end up with a face full of wall.

You duck out of the way as the worm takes a chomp at you.

You take some damage -- your arm is no longer in the best shape.
You should probably let that heal.

>e
You make a lunge for the doorway...

...But end up with a face full of wall. The door seems to be south now.

You've managed to fix yourself up a little --in fact, you'd say you're at peak health!

The worm headbutts you gently.

You take some damage -- you're pretty sure that sprained something.

>e
You make a lunge for the doorway...

...But end up with a face full of wall. The door seems to be west now.

You've managed to fix yourself up a little --in fact, you'd say you're at peak health!

The worm slices at you with its razor teeth, but you dodge...mostly.

You take some damage -- now there's a nasty-looking gash on your knee.

>e
You make a lunge for the doorway...

...And make it into the spare room.

spare room
This room is pretty dim and empty. There are a green chair, a blue chair and a yellow chair huddled in the corner.

There's a large decorative door to the south that you're pretty sure could hold back the worm.

You've managed to fix yourself up a little --in fact, you'd say you're at peak health!

The giant worm manages to squeeze through its current door, but gets stuck again in the next one. It wiggles through slowly and carefully, so as not to hurt the frame (but makes sure to snap viciously at you anyway).

* * *

>take chair
Which do you mean, the green chair, the blue chair or the yellow chair?

>put blue chair on green chair
(first taking the blue chair)
You put the blue chair on the green chair.

The worm swings its head at you like a wrecking ball. You slam into the wall.

You take some damage -- a bruise forms just below your hairline.

>take green chair
Taken.

You've managed to fix yourself up a little --in fact, you'd say you're at peak health!

The worm swings its head at you like a wrecking ball. You slam into the wall.

You take some damage -- now there's a nasty-looking gash on your knee.

>s
you slam the door shut and lock it behind you.

living room
There's a large decorative door to the east. It's locked tight.

A mannequin sits in the corner of the room.

There's a single red door leading to the hallway.

>give chair to mannequin
(the green chair to the mannequin)
The mannequin refuses to take the green chair; that'd just be bad manners.

>talk to mannequin
you ask the mannequin about themself.

The mannequin shifts. Its arms seem to move independently of...themselves. That is, although they stay stiffly crossed behind the mannequin's back, they also gesture -- almost like a hologram -- as it tries to speak...

...Unfortunately, the mannequin does not seem to have a mouth. It pauses to consider this fact.

You've managed to fix yourself up a little --in fact, you'd say you're at peak health!

After a few moments of deliberation, the mannequin opts to communicate by poking at your head.

Poke pokepoke poke poke poke, poke pokepoke poke poke poke poke pokepokepoke...

>tell mannequin to stop
Finally, you snap. You swat the mannequin's hand and tell it to stop.
The mannequin reluctantly withdraws and respects your personal space.

>offer chairs
(the green chair to the mannequin)
The mannequin picks up the stack of chairs.

>offer chair
Which do you mean, the green chair or the blue chair?

>the green chair
(to the mannequin)
(first taking the green chair)
That seems to belong to the mannequin.

>ask mannequin about door
The mannequin considers. It looks at the door. It rolls up its sleeves. With all its energy, it dramatically wiggles its fingers...

...Nothing. The mannequin seems disappointed. Melancholy, even. It'll never be a real wizard.

With a bit of a disappointed slouch and a little patting around at its pockets, the mannequin produces a key and unlocks the door for you.

>n
(first opening the red door)

hallway
This was once your lengthy, rectangular hallway. But now it's some strange, circular room with a tiled design on the floor.

There's a single red door leading to a strange multitude of places.

The mannequin follows.

>l
hallway
This was once your lengthy, rectangular hallway. But now it's some strange, circular room with a tiled design on the floor.

The mannequin sways to some nonexistent tune.

There's a single red door leading to a strange multitude of places.

>examine floor
The design points in each of the cardinal directions: north, south, east, and west are all tiled in white granite.

>w
You make a lunge for the doorway...

...But end up with a face full of wall. The door seems to be north now.

>w
You make a lunge for the doorway...

...But end up with a face full of wall. The door seems to be south now.

* * *

ConText
An Interactive Fiction by Zoe "Fish" Cagle
Release 1 / Serial number 160117 / Inform 7 build 6M62 (I6/v6.33 lib 6/12N) SD

bedroom
You're pretty sure this used to be your bedroom... This must be some kind of weird dream.

A standard-issue maroon chair sits awkwardly in the corner.

There aren't any doors in or out, but there's a window to the east.

>take chair
Taken.

>go backwards through window
(the window)
(first looking away from the window)
You stare pointedly at the other side of the room. The window seems relieved.

(first opening the window)
Watching the far wall, you back up to the window and tug at the pane. Your arms don't quite bend that way, but you manage to slide it open eventually.

Carefully, you step backwards through the window. It's very a stressful moment for you both. But with some manuvering, you fall ungracefully into the next room.

hallway
This was once your lengthy, rectangular hallway. But now it's some strange, circular room with a tiled design on the floor.

The window appears to have fled.

There's a single red door leading to what you're reasonably sure is the kitchen.

>n
You make a lunge for the doorway...
...But end up with a face full of wall.

* * *

>n
You make a lunge for the doorway...

...But end up with a face full of wall. The door seems to be east now.

>n
You make a lunge for the doorway...

...And make it into the Kitchen.

Kitchen
Well, at least the kitchen looks mildly familiar. On the counter is an innocuous black box.

You can see a small hopper window, but it's too high to reach.

There's a single red door to the south, leading back to the hallway.

>press button
Click.

>talk to worm
you ask the giant worm about the weather.

The giant worm is pleased that you acknowledged it. It promptly begins to gnash its teeth viciously at you in response. The giant worm has many teeth.

>s
hallway
This was once your lengthy, rectangular hallway. But now it's some strange, circular room with a tiled design on the floor.

There's a single red door leading to what you're reasonably sure is the kitchen.

The giant worm tries to follow, but gets stuck in the door. It wiggles through slowly and carefully, so as not to hurt the frame (but makes sure to snap viciously at you anyway).

>e
You make a lunge for the doorway...
...But end up with a face full of wall.

You duck out of the way as the worm takes a chomp at you.

You take some damage -- you're pretty sure that sprained something.
You should probably let that heal.

>e
You make a lunge for the doorway...

...But end up with a face full of wall. The door seems to be south now.

The worm slices at you with its razor teeth, but you dodge...mostly.

You take some damage -- now there's a nasty-looking gash on your knee.

>e
You make a lunge for the doorway...

...But end up with a face full of wall. The door seems to be west now.

The worm headbutts you gently.

You take some damage -- a bruise forms just below your hairline.

>e
You make a lunge for the doorway...

...And make it into the spare room.

spare room
This room is pretty dim and empty. There are a green chair, a blue chair and a yellow chair huddled in the corner.

There's a large decorative door to the south that you're pretty sure could hold back the worm.

There's a single red door leading west to the hallway.

The giant worm manages to squeeze through its current door, but gets stuck again in the next one. It wiggles through slowly and carefully, so as not to hurt the frame (but makes sure to snap viciously at you anyway).

>put maroon chair on green chair
You put the maroon chair on the green chair.

The worm slices at you with its razor teeth, but you dodge...mostly.

You take some damage -- a bruise forms just below your hairline.

>take green chair
Taken.

You duck out of the way as the worm takes a chomp at you.

You take some damage -- now there's a nasty-looking gash on your knee.

>s
you slam the door shut and lock it behind you.

living room
There's a large decorative door to the east. It's locked tight.

A mannequin sits in the corner of the room.

There's a single red door leading to the hallway.